11111111111111
1C000000000001
11101111110001
10000000010101
1011110101C1P1
10000101010111
101000E1C10001
10101111110001
10100000000101
10111111100101
100C1000001101
10011001111001
100000000000C1
11111111111111